F3L312_Canada_Atlantic_Autumn	Canada_Autumn
F3L337_Canada_Atlantic_Autumn	Canada_Autumn
F4TH327_Canada_Atlantic_Autumn	Canada_Autumn
F4TH337_Canada_Atlantic_Autumn	Canada_Autumn
F4XQgb402_Canada_Atlantic_Autumn	Canada_Autumn
F4XQgb408_Canada_Atlantic_Autumn	Canada_Autumn
S3Ps246_Canada_Atlantic_Spring	Canada_Spring
S3Ps259_Canada_Atlantic_Spring	Canada_Spring
S4TH231_Canada_Atlantic_Spring	Canada_Spring
S4TH244_Canada_Atlantic_Spring	Canada_Spring
S4TM205_Canada_Atlantic_Spring	Canada_Spring
S4TM211_Canada_Atlantic_Spring	Canada_Spring
AAL1_CelticSea_Atlantic_Winter	UK
AAL2_CelticSea_Atlantic_Winter	UK
AAL3_Celticsea_Atlantic_Winter	UK
CS10	UK
CS4	UK
CS5	UK
CS7	UK
CS8	UK
CS2	UK
AK1_Downs_Atlantic_Winter	UK
AK2_Downs_Atlantic_Winter	UK
AK3_Downs_Atlantic_Winter	UK
Z12_IsleofMan_Atlantic_Autumn	UK
Z14_IsleofMan_Atlantic_Autumn	UK
Z4_IsleofMan_Atlantic_Autumn	UK
NorthSea13_NorthSea_Atlantic_Autumn	NorthSea
NorthSea19_NorthSea_Atlantic_Autumn	NorthSea
NorthSea34_NorthSea_Atlantic_Autumn	NorthSea
AF29_Norway_Atlantic_Spring	Norway_Spring
AF30_Norway_Atlantic_Spring	Norway_Spring
AF31_Norway_Atlantic_Spring	Norway_Spring
AF8_Norway_Atlantic_Spring	Norway_Spring
AM27_Norway_Atlantic_Spring	Norway_Spring
AM29_Norway_Atlantic_Spring	Norway_Spring
AM33_Norway_Atlantic_Spring	Norway_Spring
AM8_Norway_Atlantic_Spring	Norway_Spring
NSSH33_Norway_Atlantic_Spring	Norway_Spring
NSSH34_Norway_Atlantic_Spring	Norway_Spring
NSSH36_Norway_Atlantic_Spring	Norway_Spring
F1	Baltic_Spring
F2	Baltic_Spring
F3	Baltic_Spring
F4	Baltic_Spring
F5	Baltic_Spring
F6	Baltic_Spring
Fehmarn3_Fehmarn_Baltic_Autumn	Baltic_Autumn
Fehmarn44_Fehmarn_Baltic_Autumn	Baltic_Autumn
Fehmarn6_Fehmarn_Baltic_Autumn	Baltic_Autumn
Gavle100_Gavle_Baltic_Autumn	Baltic_Autumn
Gavle54_Gavle_Baltic_Autumn	Baltic_Autumn
Gavle98_Gavle_Baltic_Autumn	Baltic_Autumn
BF16_HastKar_Baltic_Spring	Baltic_Spring
BF18_HastKar_Baltic_Spring	Baltic_Spring
BF19_HastKar_Baltic_Spring	Baltic_Spring
BF21_HastKar_Baltic_Spring	Baltic_Spring
BM14_HastKar_Baltic_Spring	Baltic_Spring
BM15_HastKar_Baltic_Spring	Baltic_Spring
BM16_HastKar_Baltic_Spring	Baltic_Spring
BM19_HastKar_Baltic_Spring	Baltic_Spring
