F3L312_Canada_Atlantic_Autumn	Atlantic
F3L337_Canada_Atlantic_Autumn	Atlantic
F4TH327_Canada_Atlantic_Autumn	Atlantic
F4TH337_Canada_Atlantic_Autumn	Atlantic
F4XQgb402_Canada_Atlantic_Autumn	Atlantic
F4XQgb408_Canada_Atlantic_Autumn	Atlantic
S3Ps246_Canada_Atlantic_Spring	Atlantic
S3Ps259_Canada_Atlantic_Spring	Atlantic
S4TH231_Canada_Atlantic_Spring	Atlantic
S4TH244_Canada_Atlantic_Spring	Atlantic
S4TM205_Canada_Atlantic_Spring	Atlantic
S4TM211_Canada_Atlantic_Spring	Atlantic
AAL1_CelticSea_Atlantic_Winter	Atlantic
AAL2_CelticSea_Atlantic_Winter	Atlantic
AAL3_Celticsea_Atlantic_Winter	Atlantic
CS10	Atlantic
CS4	Atlantic
CS5	Atlantic
CS7	Atlantic
CS8	Atlantic
CS2	Atlantic
AK1_Downs_Atlantic_Winter	Atlantic
AK2_Downs_Atlantic_Winter	Atlantic
AK3_Downs_Atlantic_Winter	Atlantic
Z12_IsleofMan_Atlantic_Autumn	Atlantic
Z14_IsleofMan_Atlantic_Autumn	Atlantic
Z4_IsleofMan_Atlantic_Autumn	Atlantic
NorthSea13_NorthSea_Atlantic_Autumn	Atlantic
NorthSea19_NorthSea_Atlantic_Autumn	Atlantic
NorthSea34_NorthSea_Atlantic_Autumn	Atlantic
AF29_Norway_Atlantic_Spring	Atlantic
AF30_Norway_Atlantic_Spring	Atlantic
AF31_Norway_Atlantic_Spring	Atlantic
AF8_Norway_Atlantic_Spring	Atlantic
AM27_Norway_Atlantic_Spring	Atlantic
AM29_Norway_Atlantic_Spring	Atlantic
AM33_Norway_Atlantic_Spring	Atlantic
AM8_Norway_Atlantic_Spring	Atlantic
NSSH33_Norway_Atlantic_Spring	Atlantic
NSSH34_Norway_Atlantic_Spring	Atlantic
NSSH36_Norway_Atlantic_Spring	Atlantic
F1	Atlantic
F2	Atlantic
F3	Atlantic
F4	Atlantic
F5	Atlantic
F6	Atlantic
Fehmarn3_Fehmarn_Baltic_Autumn	Atlantic
Fehmarn44_Fehmarn_Baltic_Autumn	Atlantic
Fehmarn6_Fehmarn_Baltic_Autumn	Atlantic
Gavle100_Gavle_Baltic_Autumn	Atlantic
Gavle54_Gavle_Baltic_Autumn	Atlantic
Gavle98_Gavle_Baltic_Autumn	Atlantic
BF16_HastKar_Baltic_Spring	Atlantic
BF18_HastKar_Baltic_Spring	Atlantic
BF19_HastKar_Baltic_Spring	Atlantic
BF21_HastKar_Baltic_Spring	Atlantic
BM14_HastKar_Baltic_Spring	Atlantic
BM15_HastKar_Baltic_Spring	Atlantic
BM16_HastKar_Baltic_Spring	Atlantic
BM19_HastKar_Baltic_Spring	Atlantic
HWS61_Balsfjord_Atlantic	Pacific
HWS62_Balsfjord_Atlantic	Pacific
HWS63_Balsfjord_Atlantic	Pacific
HWS64_Balsfjord_Atlantic	Pacific
HWS21_PechoraSea_BarentsSea	Pacific
HWS22_PechoraSea_BarentsSea	Pacific
HWS23_PechoraSea_BarentsSea	Pacific
HWS24_PechoraSea_BarentsSea	Pacific
HWS11_Japan_SeaofJapan	Pacific
HWS12_Japan_SeaofJapan	Pacific
HWS13_Japan_SeaofJapan	Pacific
HWS14_Japan_SeaofJapan	Pacific
HWS41_KandalakshaBay_WhiteSea_Spring	Pacific
HWS42_KandalakshaBay_WhiteSea_Spring	Pacific
HWS43_KandalakshaBay_WhiteSea_Spring	Pacific
HWS44_KandalakshaBay_WhiteSea_Spring	Pacific
HWS51_KandalakshaBay_WhiteSea_Summer	Pacific
HWS52_KandalakshaBay_WhiteSea_Summer	Pacific
HWS53_KandalakshaBay_WhiteSea_Summer	Pacific
HWS54_KandalakshaBay_WhiteSea_Summer	Pacific
HWS31_WhiteSea_WhiteSea	Pacific
HWS32_WhiteSea_WhiteSea	Pacific
HWS33_WhiteSea_WhiteSea	Pacific
HWS34_WhiteSea_WhiteSea	Pacific
Pacific16_Vancouver_Pacific	Pacific
Pacific30_Vancouver_Pacific	Pacific
Pacific35_Vancouver_Pacific	Pacific
Pacific3_Vancouver_Pacific	Pacific
Pacific44_Vancouver_Pacific	Pacific
Pacific5_Vancouver_Pacific	Pacific
